13 16
0 0 1 1 1 0 0 0 0 0 0 0 0 0 0 0
1 1 1 100 1 1 1 1 0 0 0 0 0 0 0 0
1 0 75 0 75 0 0 1 0 0 1 1 1 1 1 1
1 39 0 50 0 0 37 1 1 1 1 0 0 0 32 1
1 75 0 38 0 0 0 0 50 27 0 0 0 50 0 1
1 1 1 1 1 1 1 1 1 1 1 35 75 0 0 1
0 0 0 0 0 0 0 0 0 0 1 1 1 1 22 1
0 0 0 0 0 0 0 0 0 0 0 0 0 1 0 1
0 0 0 0 0 0 0 0 0 0 1 1 1 1 0 1
0 0 0 0 0 0 0 0 0 0 1 75 34 0 0 1
0 0 0 0 0 0 0 0 0 0 1 52 0 0 0 1
0 0 0 0 0 0 0 0 0 0 1 1 1 1 75 1
0 0 0 0 0 0 0 0 0 0 0 0 0 1 1 1
0 0 0 0 0 0 0 0 0 0 0 0 0 0 0 0
0 0 0 1 0 0 0 0 0 0 0 0 0 0 0 0
0 1 1 1 1 1 1 0 0 0 0 0 0 0 0 0
0 1 1 1 1 1 1 0 0 0 0 1 1 1 1 0
0 1 1 1 1 1 1 1 1 1 1 1 1 1 1 0
0 0 0 0 0 0 0 0 0 0 0 1 1 1 1 0
0 0 0 0 0 0 0 0 0 0 0 0 0 0 1 0
0 0 0 0 0 0 0 0 0 0 0 0 0 0 1 0
0 0 0 0 0 0 0 0 0 0 0 0 0 0 1 0
0 0 0 0 0 0 0 0 0 0 0 1 1 1 1 0
0 0 0 0 0 0 0 0 0 0 0 1 1 1 1 0
0 0 0 0 0 0 0 0 0 0 0 0 0 0 1 0
0 0 0 0 0 0 0 0 0 0 0 0 0 0 0 0