3111i115
200020o2
h1016002
20000002
h1t1i116
20002000
20002000
41116000