3 1 1 1 9 1 1 5
2 0 100 0 2 0 30 2
8 1 0 1 6 0 0 2
2 0 0 0 0 0 0 2
8 1 22 1 9 1 1 6
2 0 0 0 2 0 0 0
2 0 0 0 2 0 0 0
4 1 1 1 6 0 0 0