3 1 1 1 5 0 0 0 3 1 1 1 5
2 0 100 0 8 1 1 1 10 0 0 0 2
2 0 0 0 2 30 0 0 2 0 0 0 2
2 0 0 0 21 0 0 0 8 1 20 1 10
2 0 0 0 2 0 0 0 2 0 0 0 2
2 0 0 0 2 0 0 0 2 0 0 0 2
4 1 1 9 11 1 22 1 11 1 22 1 10
0 0 0 2 30 0 0 0 0 0 0 0 2
0 0 0 2 0 0 0 0 0 0 0 0 2
0 0 0 2 0 0 0 0 3 1 1 1 6
0 0 0 2 0 0 0 0 2 0 0 0 0
0 0 0 2 0 0 0 0 2 0 0 0 0
0 0 0 4 1 1 1 1 6 0 0 0 0