3111500031115
2000h111j0o02
2000200020002
2000s000h1r1j
2000200020002
20o0200020002
411ik1t1k1t1j
00020000o0002
0002000000002
0002000031116
0002000020000
00020o0020000
0004111160000