000031115000003111500
000020002000002000200
0031kt11ki1111kt50200
002000000u00000020200
002000000200000020200
002000311k150000htk15
31j000200002000020002
202000u00002000020002
20u0002000020000s0002
202000411i16000020002
41j0000002000000h1116
002000000u00000020000
00h111ti1k11i11160000
002000020000200000000
0020000u0000200000000
0041111k1111600000000