19 14
1 1 1 1 1 0 0 0 1 1 1 1 1 0
1 100 36 36 1 1 1 1 1 50 0 32 1 0
1 0 0 0 1 0 0 50 1 41 0 71 1 0
1 50 0 0 21 0 0 71 1 1 24 1 1 0
1 0 0 0 1 0 0 71 1 34 0 32 1 0
1 35 75 41 1 72 0 0 1 40 0 75 1 0
1 1 1 1 1 1 22 1 1 1 22 1 1 0
1 75 0 1 30 0 0 0 0 0 0 75 1 0
1 1 24 1 0 71 73 0 0 0 0 37 1 0
1 0 0 1 0 0 0 0 1 1 1 1 1 1
1 39 0 21 0 71 73 0 23 0 70 70 75 1
1 0 0 1 0 0 0 0 1 0 0 0 0 1
1 39 0 1 1 1 1 1 1 35 0 0 41 1
1 0 0 0 0 0 0 50 1 1 1 1 1 1
1 1 1 1 1 26 1 1 1 30 0 0 52 1
1 30 0 0 0 0 0 0 0 0 0 0 37 1
1 0 75 0 0 0 0 0 0 0 75 0 0 1
1 0 0 0 0 0 0 0 38 0 0 0 0 1
1 1 1 1 1 1 1 1 1 1 1 1 1 1
0 0 0 0 0 0 0 0 0 0 0 0 0 0
0 1 1 1 0 0 0 0 0 1 1 1 0 0
0 1 1 1 0 1 1 1 0 1 1 1 0 0
0 1 1 1 0 1 1 1 0 0 0 0 0 0
0 1 1 1 0 1 1 1 0 1 1 1 0 0
0 1 1 1 0 1 1 1 0 1 1 1 0 0
0 0 0 0 0 0 0 0 0 0 0 0 0 0
0 1 1 0 1 1 1 1 1 1 1 1 0 0
0 0 0 0 1 1 1 1 1 1 1 1 0 0
0 1 1 0 1 1 1 1 0 0 0 0 0 0
0 1 1 0 1 1 1 1 0 1 1 1 1 0
0 1 1 0 1 1 1 1 0 1 1 1 1 0
0 1 1 0 0 0 0 0 0 1 1 1 1 0
0 1 1 1 1 1 1 1 0 0 0 0 0 0
0 0 0 0 0 0 0 0 0 1 1 1 1 0
0 1 1 1 1 1 1 1 1 1 1 1 1 0
0 1 1 1 1 1 1 1 1 1 1 1 1 0
0 1 1 1 1 1 1 1 1 1 1 1 1 0
0 0 0 0 0 0 0 0 0 0 0 0 0 0
30 1 0 11 12
30 1 1 11 4
30 1 2 7 4
30 0 0 17 7
30 0 1 15 7
30 0 2 15 1
30 0 3 17 1
30 2 0 14 11
30 2 1 17 11
30 2 2 17 9
30 2 3 14 9
41 3 5 4 3
40 9 5 10 3
41 12 12 3 10
41 9 2 5 14