13 16
1 1 1 0 0 0 0 0 0 0 0 1 1 1 1 1
1 100 1 1 1 1 1 0 0 0 0 1 52 0 75 1
1 0 1 73 40 50 1 0 0 0 0 1 35 0 41 1
1 80 1 1 1 26 1 1 1 1 1 1 1 0 37 1
1 0 0 81 0 0 0 81 0 0 0 0 27 0 37 1
1 1 1 1 1 1 26 1 1 1 1 0 1 50 0 1
1 75 52 1 300 0 0 0 300 37 1 0 1 1 1 1
1 1 20 1 75 0 70 70 0 75 1 80 1 75 36 1
0 1 0 1 30 300 0 0 300 37 1 0 1 52 30 1
0 1 0 1 1 1 1 1 1 1 1 24 1 300 0 1
0 1 0 300 0 0 36 75 36 0 0 0 0 0 0 1
0 1 75 300 0 0 0 0 0 0 0 0 0 0 300 1
0 1 1 1 1 1 1 1 1 1 1 1 1 1 1 1
0 0 0 0 0 0 0 0 0 0 0 0 0 0 0 0
0 1 0 0 0 0 0 0 0 0 0 0 1 1 1 0
0 1 0 1 1 1 0 0 0 0 0 0 1 1 1 0
0 1 0 0 0 0 0 0 0 0 0 0 0 1 1 0
0 1 1 1 1 1 1 1 1 1 1 1 0 1 1 0
0 0 0 0 0 0 0 0 0 0 0 1 0 1 1 0
0 1 1 0 1 1 1 1 1 1 0 1 0 0 0 0
0 0 0 0 1 1 1 1 1 1 0 1 0 1 1 0
8 0 1 0 1 1 1 1 1 1 0 1 0 1 1 0
8 0 1 0 0 0 0 0 0 0 0 0 0 1 1 0
8 0 1 1 1 1 1 1 1 1 1 1 1 1 1 0
8 0 1 1 1 1 1 1 1 1 1 1 1 1 1 0
8 0 0 0 0 0 0 0 0 0 0 0 0 0 0 0
30 0 0 6 4
30 0 1 6 8
30 0 2 8 8
30 0 3 8 5
30 1 0 11 14
30 1 1 11 3
30 1 2 10 3
30 1 3 9 13
40 4 2 11 9
41 14 2 2 7