20 18
0 0 1 1 1 1 1 1 1 1 1 1 0 0 0 0 0 0
0 0 1 0 0 0 81 0 0 0 0 1 0 0 0 0 0 0
0 0 1 0 1 1 1 1 1 1 0 1 0 0 0 0 0 0
0 0 1 0 1 34 36 36 0 27 0 1 0 0 0 0 0 0
0 0 1 26 1 50 0 0 0 1 26 1 0 0 0 0 0 0
0 0 1 0 1 75 0 38 0 1 0 1 0 0 0 0 0 0
1 1 1 0 1 1 1 1 1 1 0 1 0 0 0 0 0 0
1 100 0 0 0 0 0 81 81 0 0 1 0 0 0 0 0 0
1 1 0 1 1 24 1 1 1 1 26 1 0 0 0 0 0 0
0 1 0 1 75 0 1 50 70 70 0 1 0 0 0 0 0 0
0 1 0 1 73 0 1 40 0 0 0 1 0 0 0 0 0 0
0 1 80 1 73 0 1 1 1 1 1 1 1 1 1 1 1 1
0 1 0 1 63 0 0 0 27 300 0 75 34 32 1 52 54 1
0 1 0 1 1 1 1 1 1 0 0 0 0 33 1 1 20 1
0 1 0 0 0 81 0 0 65 0 0 0 0 0 0 300 30 1
0 1 1 1 1 1 1 1 0 0 0 0 38 0 75 1 1 1
0 0 0 0 0 0 0 1 50 0 1 1 1 1 1 1 0 0
0 0 0 0 0 0 0 1 0 0 1 34 36 75 41 1 0 0
0 0 0 0 0 0 0 1 0 0 27 0 0 300 0 1 0 0
0 0 0 0 0 0 0 1 1 1 1 1 1 1 1 1 0 0
0 0 0 0 0 0 0 0 0 0 0 0 0 0 0 0 0 0
0 0 0 1 1 1 1 1 1 1 1 0 0 0 0 0 0 0
0 0 0 1 0 0 0 0 0 0 1 0 0 0 0 0 0 0
0 0 0 1 0 1 1 1 1 0 1 0 0 0 0 0 0 0
0 0 0 0 0 1 1 1 1 0 0 0 0 0 0 0 0 0
0 0 0 1 0 1 1 1 1 0 1 0 0 0 0 0 0 0
0 0 0 1 0 0 0 0 0 0 1 0 0 0 0 0 0 0
0 1 1 1 1 1 1 1 1 1 1 0 0 0 0 0 0 0
0 0 1 0 0 0 0 0 0 0 0 0 0 0 0 0 0 0
0 0 1 0 1 1 0 1 1 1 1 0 0 0 0 0 0 0
0 0 1 0 1 1 0 1 1 1 1 0 0 0 0 0 0 0
0 0 1 0 1 1 0 0 0 0 0 0 0 0 0 0 0 0
0 0 1 0 1 1 1 1 0 1 1 1 1 1 0 1 1 0
0 0 1 0 0 0 0 0 0 1 1 1 1 1 0 0 0 0
0 0 1 1 1 1 1 1 1 1 1 1 1 1 1 1 1 0
0 0 0 0 0 0 0 0 1 1 1 1 1 1 1 0 0 0
0 0 0 0 0 0 0 0 1 1 0 0 0 0 0 0 0 0
0 0 0 0 0 0 0 0 1 1 0 1 1 1 1 0 0 0
0 0 0 0 0 0 0 0 1 1 0 1 1 1 1 0 0 0
0 0 0 0 0 0 0 0 0 0 0 0 0 0 0 0 0 0
30 0 0 12 9
30 0 1 18 13
30 0 2 14 15
63 4 12 8 14
40 7 10 5 8
41 14 17 16 13