12 15
0 0 0 0 0 0 1 1 1 1 1 1 1 1 1
1 1 1 1 1 1 1 50 0 0 0 36 0 75 1
1 100 0 0 0 27 0 0 0 0 0 0 0 32 1
1 0 0 33 1 1 1 1 26 1 0 0 0 0 1
1 75 0 75 1 50 0 0 0 1 39 0 0 33 1
1 1 26 1 1 1 1 0 0 1 75 0 0 0 1
1 75 0 0 36 32 1 34 0 1 1 1 26 1 1
1 0 0 0 0 0 1 35 0 50 1 0 0 36 1
1 39 0 0 0 0 1 75 0 71 1 0 0 0 1
1 50 0 72 72 0 27 0 0 71 1 50 0 0 1
1 75 0 70 70 0 1 1 1 1 1 75 0 51 1
1 1 1 1 1 1 1 0 0 0 1 1 1 1 1
0 0 0 0 0 0 0 0 0 0 0 0 0 0 0
0 0 0 0 0 0 0 1 1 1 1 1 1 1 0
0 1 1 1 1 0 1 1 1 1 1 1 1 1 0
0 1 1 1 0 0 0 0 0 0 1 1 1 1 0
0 1 1 1 0 1 1 1 1 0 1 1 1 1 0
0 0 0 0 0 0 0 1 1 0 1 1 1 1 0
0 1 1 1 1 1 0 1 1 0 0 0 0 0 0
0 1 1 1 1 1 0 1 1 1 0 1 1 1 0
0 1 1 1 1 1 0 1 1 1 0 1 1 1 0
0 1 1 1 1 1 0 1 1 1 0 1 1 1 0
0 1 1 1 1 1 0 0 0 0 0 1 1 1 0
0 0 0 0 0 0 0 0 0 0 0 0 0 0 0