3111i115
20002002
h1r16002
200ooo02
h1t1i116
20002000
20002000
41116000