12 15
0 0 0 0 0 0 1 1 1 1 1 1 1 1 1
1 1 1 1 1 1 1 50 0 0 0 0 0 0 1
1 100 0 0 0 23 0 0 0 0 0 0 0 32 1
1 0 0 32 1 1 1 1 22 1 0 0 0 0 1
1 0 0 0 1 50 0 0 0 1 39 0 0 33 1
1 1 22 1 1 1 1 0 0 1 0 0 0 0 1
1 0 0 0 36 32 1 34 0 1 1 1 22 1 1
1 0 0 0 0 0 1 35 0 50 1 0 0 36 1
1 39 0 0 0 0 1 0 0 0 1 0 0 0 1
1 0 0 0 0 0 23 0 0 0 1 50 0 0 1
1 50 0 38 0 0 1 1 1 1 1 0 0 0 1
1 1 1 1 1 1 1 0 0 0 1 1 1 1 1
1 1 1 1 1 1 -1 -1 -1 -1 -1 -1 -1 -1 -1
-1 -1 -1 -1 -1 -1 -1 2 2 2 2 2 2 2 -1
-1 3 3 3 3 -1 2 2 2 2 2 2 2 2 -1
-1 3 3 3 -1 -1 -1 -1 -1 -1 2 2 2 2 -1
-1 3 3 3 -1 4 4 4 4 -1 2 2 2 2 -1
-1 -1 -1 -1 -1 -1 -1 4 4 -1 2 2 2 2 -1
-1 5 5 5 5 5 -1 4 4 -1 -1 -1 -1 -1 -1
-1 5 5 5 5 5 -1 4 4 4 -1 6 6 6 -1
-1 5 5 5 5 5 -1 4 4 4 -1 6 6 6 -1
-1 5 5 5 5 5 -1 4 4 4 -1 6 6 6 -1
-1 5 5 5 5 5 -1 -1 -1 -1 -1 6 6 6 -1
-1 -1 -1 -1 -1 -1 -1 7 8 9 -1 -1 -1 -1 -1