14 20
1 1 1 1 1 0 0 0 0 0 0 0 0 0 0 0 0 0 0 0
1 100 75 32 1 0 0 0 0 1 1 1 1 1 1 1 0 0 0 0
1 0 0 0 1 1 1 1 1 1 34 0 36 0 32 1 1 1 1 1
1 35 0 0 23 0 0 70 70 1 0 0 0 0 0 23 0 0 75 1
1 1 1 1 1 0 0 0 0 21 0 75 0 75 0 1 73 0 37 1
1 0 0 50 1 41 72 72 0 1 1 1 22 1 1 1 73 0 40 1
1 1 0 71 1 1 1 1 22 1 75 0 0 0 75 1 1 20 1 1
0 1 20 1 1 39 0 0 0 1 34 0 0 0 71 1 75 0 32 1
1 1 0 75 1 41 0 0 33 1 0 0 0 0 0 1 0 0 51 1
1 39 0 0 1 1 20 1 1 1 35 0 38 0 0 1 22 1 1 1
1 75 0 0 0 0 0 0 32 1 1 1 1 1 22 1 0 1 0 0
1 39 0 0 50 0 0 0 33 1 50 0 36 36 0 0 0 1 0 0
1 1 1 1 1 1 1 1 1 1 0 0 0 0 0 0 50 1 0 0
0 0 0 0 0 0 0 0 0 1 1 1 1 1 1 1 1 1 0 0
-1 -1 -1 -1 -1 1 1 1 1 1 1 1 1 1 1 1 1 1 1 1
-1 2 2 2 -1 1 1 1 1 -1 -1 -1 -1 -1 -1 -1 1 1 1 1
-1 2 2 2 -1 -1 -1 -1 -1 -1 3 3 3 3 3 -1 -1 -1 -1 -1
-1 2 2 2 -1 4 4 4 4 -1 3 3 3 3 3 -1 5 5 5 -1
-1 -1 -1 -1 -1 4 4 4 4 -1 3 3 3 3 3 -1 5 5 5 -1
-1 6 6 6 -1 4 4 4 4 -1 -1 -1 -1 -1 -1 -1 5 5 5 -1
-1 -1 6 6 -1 -1 -1 -1 -1 -1 7 7 7 7 7 -1 -1 -1 -1 -1
8 -1 -1 -1 -1 9 9 9 9 -1 7 7 7 7 7 -1 10 10 10 -1
-1 -1 11 11 -1 9 9 9 9 -1 7 7 7 7 7 -1 10 10 10 -1
-1 11 11 11 -1 -1 -1 -1 -1 -1 7 7 7 7 7 -1 -1 -1 -1 -1
-1 11 11 11 11 11 11 11 11 -1 -1 -1 -1 -1 -1 -1 12 -1 13 13
-1 11 11 11 11 11 11 11 11 -1 12 12 12 12 12 12 12 -1 13 13
-1 -1 -1 -1 -1 -1 -1 -1 -1 -1 12 12 12 12 12 12 12 -1 13 13
14 15 16 17 18 19 20 21 22 -1 -1 -1 -1 -1 -1 -1 -1 -1 13 23
41 5 5 2 7
41 5 8 9 4
40 18 5 6 9