3111500031115
2000h111j0002
2000200020002
2000s000h1r1j
2000200020002
2000200020002
411ik1t1k1t1j
0002000000002
0002000000002
0002000031116
0002000020000
0002000020000
0004111160000