14 20
1 1 1 1 1 0 0 0 0 0 0 0 0 0 0 0 0 0 0 0
1 100 75 32 1 0 0 0 0 1 1 1 1 1 1 1 0 0 0 0
1 0 0 0 1 1 1 1 1 1 34 0 36 0 32 1 1 1 1 1
1 35 0 0 27 0 0 70 70 1 0 0 0 0 0 27 0 0 75 1
1 1 1 1 1 0 0 0 0 21 0 75 0 75 0 1 73 0 37 1
1 0 0 50 1 41 72 72 0 1 1 1 26 1 1 1 73 0 40 1
1 1 0 71 1 1 1 1 22 1 75 0 0 0 75 1 1 24 1 1
0 1 20 1 1 39 0 0 0 1 34 0 0 0 71 1 75 0 32 1
1 1 0 75 1 41 0 0 33 1 0 0 0 0 0 1 0 0 51 1
1 39 0 0 1 1 24 1 1 1 35 0 38 0 0 1 26 1 1 1
1 75 0 0 0 0 0 0 32 1 1 1 1 1 26 1 0 1 0 0
1 39 0 0 50 0 0 0 33 1 50 0 36 36 0 0 0 1 0 0
1 1 1 1 1 1 1 1 1 1 0 0 0 0 0 0 50 1 0 0
0 0 0 0 0 0 0 0 0 1 1 1 1 1 1 1 1 1 0 0
0 0 0 0 0 1 1 1 1 1 1 1 1 1 1 1 1 1 1 1
0 1 1 1 0 1 1 1 1 0 0 0 0 0 0 0 1 1 1 1
0 1 1 1 0 0 0 0 0 0 1 1 1 1 1 0 0 0 0 0
0 1 1 1 0 1 1 1 1 0 1 1 1 1 1 0 1 1 1 0
0 0 0 0 0 1 1 1 1 0 1 1 1 1 1 0 1 1 1 0
0 1 1 1 0 1 1 1 1 0 0 0 0 0 0 0 1 1 1 0
0 0 1 1 0 0 0 0 0 0 1 1 1 1 1 0 0 0 0 0
8 0 0 0 0 1 1 1 1 0 1 1 1 1 1 0 1 1 1 0
0 0 1 1 0 1 1 1 1 0 1 1 1 1 1 0 1 1 1 0
0 1 1 1 0 0 0 0 0 0 1 1 1 1 1 0 0 0 0 0
0 1 1 1 1 1 1 1 1 0 0 0 0 0 0 0 1 0 0 0
0 1 1 1 1 1 1 1 1 0 1 1 1 1 1 1 1 0 0 0
0 0 0 0 0 0 0 0 0 0 1 1 1 1 1 1 1 0 0 0
0 0 0 0 0 0 0 0 0 0 0 0 0 0 0 0 0 0 0 0
41 5 5 2 7
41 5 8 9 4
40 18 5 6 9