18 15
1 1 1 1 1 1 1 1 1 1 1 1 1 0 0
1 75 0 0 34 50 36 0 36 1 0 75 1 0 0
1 0 0 0 0 0 0 0 0 25 0 0 1 0 0
1 0 0 1 1 1 1 1 1 1 0 0 1 0 0
1 0 0 21 0 75 0 32 1 34 0 40 1 0 0
1 41 75 1 0 0 0 75 1 0 0 1 1 1 1
1 1 1 1 75 0 0 0 1 35 0 1 0 32 1
1 50 36 1 35 0 0 0 1 75 0 21 0 0 1
1 0 0 1 1 1 1 1 1 1 1 1 0 37 1
1 0 300 30 0 0 300 1 36 0 0 0 0 0 1
1 100 0 0 0 0 0 21 0 0 0 0 0 41 1
1 75 300 0 0 0 300 1 1 1 26 1 1 1 1
1 1 26 1 1 1 1 1 34 0 0 75 1 0 0
1 75 0 75 1 0 0 0 0 0 0 37 1 0 0
1 73 0 0 1 26 1 0 0 0 0 50 1 0 0
1 73 0 0 0 0 1 1 1 1 1 1 1 0 0
1 73 51 72 72 72 1 0 0 0 0 0 0 0 0
1 1 1 1 1 1 1 0 0 0 0 0 0 0 0
-1 -1 -1 -1 -1 -1 -1 -1 -1 -1 -1 -1 -1 1 1
-1 2 2 2 2 2 2 2 2 -1 3 3 -1 1 1
-1 2 2 2 2 2 2 2 2 -1 3 3 -1 1 1
-1 2 2 -1 -1 -1 -1 -1 -1 -1 3 3 -1 1 1
-1 2 2 -1 4 4 4 4 -1 3 3 3 -1 1 1
-1 2 2 -1 4 4 4 4 -1 3 3 -1 -1 -1 -1
-1 -1 -1 -1 4 4 4 4 -1 3 3 -1 5 5 -1
-1 6 6 -1 4 4 4 4 -1 3 3 -1 5 5 -1
-1 6 6 -1 -1 -1 -1 -1 -1 -1 -1 -1 5 5 -1
-1 6 6 6 6 6 6 -1 5 5 5 5 5 5 -1
-1 6 6 6 6 6 6 -1 5 5 5 5 5 5 -1
-1 6 6 6 6 6 6 -1 -1 -1 -1 -1 -1 -1 -1
-1 -1 -1 -1 -1 -1 -1 -1 7 7 7 7 -1 -1 -1
-1 9 9 9 -1 7 7 7 7 7 7 7 -1 -1 -1
-1 9 9 9 -1 -1 -1 7 7 7 7 7 -1 -1 -1
-1 9 9 9 9 9 -1 -1 -1 -1 -1 -1 -1 -1 -1
-1 9 9 9 9 9 -1 -1 -1 -1 -1 -1 -1 -1 -1
-1 -1 -1 -1 -1 -1 -1 -1 -1 -1 -1 -1 -1 -1 -1
30 0 0 9 3
30 0 1 9 6
30 0 2 11 6
30 0 3 11 2
30 0 4 9 2
41 1 5 3 4
41 13 10 11 7
40 11 4 9 2