000000000000000000000
000000000000000000000
000000003111111115000
000000002000000002000
000500002000000002000
000000002000200002000
004000002000200002000
070000002011711102000
006000002000200002000
000000002000200002000
030400002000000002000
000000002000000002000
000000004111111116000
000000000000000000000
000000000000000000000
000000000000000000000
000000000000000000000
000011111111000000000
000000000000000000000
000000000000000000000
000002222000000000000
000000000000000000000
000000003345600000000
000000000000000000000
000000000000000000000
000000722100000000000
000000000000000000000
000000000000000000000
000000000000000000000
000000000000000000000
000000000000000000000
000000000000000000000
000000000000000000000
000000000000000000000
000000000000000000000
000000003111111115000
000000002000000002000
000500002000000002000
000000002000200002000
004000002000200002000
070000002011711102000
006000002000200002000
000000002000200002000
030400002000000002000
000000002000000002000
000000004111111116000
000000000000000000000
000000000000000000000
000000000000000000000
000000000000000000000
000011111111000000000
000000000000000000000
000000000000000000000
000002222000000000000
000000000000000000000
000000003345600000000
000000000000000000000
000000000000000000000
000000722100000000000
000000000000000000000
000000000000000000000
000000000000000000000
000000000000000000000
000000000000000000000
000000000000000000000
000000000000000000000
000000000000000000000
000000000000000000000
000000003111111115000
000000002000000002000
000500002000000002000
000000002000200002000
004000002000200002000
070000002011711102000
006000002000200002000
000000002000200002000
030400002000000002000
000000002000000002000
000000004111111116000
000000000000000000000
000000000000000000000
000000000000000000000
000000000000000000000
000011111111000000000
000000000000000000000
000000000000000000000
000002222000000000000
000000000000000000000
000000003345600000000
000000000000000000000
000000000000000000000
000000722100000000000
000000000000000000000
000000000000000000000
000000000000000000000
000000000000000000000
000000000000000000000
000000000000000000000
000000000000000000000