0 0 0 0 3 1 1 1 5 0 0 0 0 0 3 1 1 1 5 0 0
0 0 0 0 2 0 0 0 2 0 0 0 0 0 2 0 0 0 2 0 0
0 0 3 1 11 22 1 1 11 9 1 1 1 1 11 22 5 0 2 0 0
0 0 2 0 0 0 0 0 0 23 0 0 0 0 0 0 2 0 2 0 0
0 0 2 0 0 0 0 0 0 2 0 0 0 0 0 0 2 0 2 0 0
0 0 2 0 0 0 3 1 1 11 1 5 0 0 0 0 8 22 11 1 5
3 1 10 0 0 0 2 0 0 0 0 2 0 0 0 0 2 0 0 0 2
2 0 2 0 0 0 23 0 0 0 0 2 0 0 0 0 2 0 0 0 2
2 0 23 0 0 0 2 0 0 0 0 2 0 0 0 0 21 0 0 0 2
2 0 2 0 0 0 4 1 1 9 1 6 0 0 0 0 2 0 0 0 2
4 1 10 0 0 0 0 0 0 2 0 0 0 0 0 0 8 1 1 1 6
0 0 2 0 0 0 0 0 0 23 0 0 0 0 0 0 2 0 0 0 0
0 0 8 1 1 1 22 9 1 11 1 1 9 1 1 1 6 0 0 0 0
0 0 2 0 0 0 0 2 0 0 0 0 2 0 0 0 0 0 0 0 0
0 0 2 0 0 0 0 23 0 0 0 30 2 0 0 0 0 0 0 0 0
0 0 4 1 1 1 1 11 1 1 1 1 6 0 0 0 0 0 0 0 0