19 14
1 1 1 1 1 0 0 0 1 1 1 1 1 0
1 100 0 37 1 1 1 1 1 50 0 32 1 0
1 0 0 0 1 0 0 50 1 41 0 71 1 0
1 50 0 0 21 0 0 71 1 1 20 1 1 0
1 0 0 0 1 0 0 71 1 34 0 32 1 0
1 35 0 41 1 72 0 0 1 40 0 0 1 0
1 1 1 1 1 1 22 1 1 1 22 1 1 0
1 75 0 1 30 0 0 0 0 0 0 0 1 0
1 1 24 1 0 71 73 0 0 0 0 37 1 0
1 0 0 1 0 0 0 0 1 1 1 1 1 1
1 39 0 21 0 71 73 0 23 0 70 70 0 1
1 0 0 1 0 0 0 0 1 0 0 0 0 1
1 39 0 1 1 1 1 1 1 35 0 0 41 1
1 0 0 0 0 0 0 50 1 1 1 1 1 1
1 1 1 1 1 20 1 1 1 30 0 0 0 1
1 30 0 0 0 0 0 0 0 0 0 0 37 1
1 0 0 0 0 0 0 0 0 0 0 0 0 1
1 0 0 0 0 0 0 0 38 0 0 0 0 1
1 1 1 1 1 1 1 1 1 1 1 1 1 1
0 0 0 0 0 0 0 0 0 0 0 0 0 0
0 1 1 1 0 0 0 0 0 1 1 1 0 0
0 1 1 1 0 1 1 1 0 1 1 1 0 0
0 1 1 1 0 1 1 1 0 0 0 0 0 0
0 1 1 1 0 1 1 1 0 1 1 1 0 0
0 1 1 1 0 1 1 1 0 1 1 1 0 0
0 0 0 0 0 0 0 0 0 0 0 0 0 0
0 0 0 0 1 1 1 1 1 1 1 1 0 0
0 0 0 0 1 1 1 1 1 1 1 1 0 0
0 1 1 0 1 1 1 1 0 0 0 0 0 0
0 1 1 0 1 1 1 1 0 1 1 1 1 0
0 1 1 0 1 1 1 1 0 1 1 1 1 0
0 1 1 0 0 0 0 0 0 1 1 1 1 0
0 1 1 1 1 1 1 1 0 0 0 0 0 0
0 0 0 0 0 0 0 0 0 1 1 1 1 0
0 1 1 1 1 1 1 1 1 1 1 1 1 0
0 1 1 1 1 1 1 1 1 1 1 1 1 0
0 1 1 1 1 1 1 1 1 1 1 1 1 0
0 0 0 0 0 0 0 0 0 0 0 0 0 0
30 0 0 16 1
30 0 1 17 1
30 0 2 17 7
30 0 3 15 7
30 1 0 15 9
30 1 1 17 9
30 1 2 17 11
30 1 3 14 11
30 2 0 8 4
30 2 1 11 4
30 2 2 12 11
30 2 3 10 7
30 2 4 7 7
30 2 5 7 5