23 22
1 1 1 1 1 1 1 1 0 0 0 0 0 0 0 0 0 0 0 0 0 0 
1 0 0 0 0 0 0 1 0 0 0 0 0 0 0 0 0 0 0 0 0 0 
1 22 1 0 0 0 0 1 0 0 0 0 0 0 0 1 1 1 1 1 1 1 
1 0 1 0 0 0 0 1 1 1 1 1 1 1 1 1 0 0 0 1 0 1 
1 0 1 30 0 0 0 23 0 0 0 0 0 0 0 23 0 0 0 1 0 1 
1 1 1 1 1 1 1 1 1 1 1 1 0 0 0 1 1 1 1 1 22 1 
1 0 0 0 1 0 0 0 1 0 0 1 0 0 0 0 0 0 0 0 0 1 
1 0 0 0 1 0 0 0 1 0 0 1 0 0 0 0 0 0 0 0 0 1 
1 1 22 1 1 1 22 1 1 1 22 1 0 0 0 1 1 1 1 1 1 1 
1 0 0 0 0 0 0 0 0 0 0 0 0 0 0 1 0 0 0 1 0 0 
1 0 0 0 0 0 0 0 0 0 0 0 0 0 0 23 0 0 0 1 0 0 
1 1 1 1 22 1 1 1 1 1 22 1 1 1 1 1 1 0 0 1 0 0 
0 0 1 0 0 0 1 0 0 1 0 1 0 0 0 0 23 0 0 1 0 0 
0 0 1 0 0 1 1 0 0 1 0 1 0 0 1 1 1 0 0 1 0 0 
0 0 1 0 0 1 0 0 0 1 0 1 0 0 1 0 0 0 0 1 0 0 
0 0 1 1 1 1 1 1 22 1 0 1 1 1 1 0 0 0 0 1 0 0 
0 0 0 0 0 1 0 0 0 0 0 0 0 0 0 0 0 1 1 1 1 1 
0 0 0 0 0 1 0 0 0 0 0 0 0 0 0 0 0 1 0 0 0 1 
0 0 1 1 1 1 22 1 1 1 22 1 1 1 0 0 0 23 0 0 0 1 
0 0 1 0 0 0 0 1 0 1 0 0 0 1 0 0 0 1 1 1 1 1 
0 0 1 0 0 0 0 1 0 1 1 1 22 1 0 0 0 1 0 0 0 1 
0 0 1 0 0 0 0 23 0 0 0 0 0 1 0 0 0 21 0 0 0 1 
0 0 1 1 1 1 1 1 1 1 1 1 1 1 1 1 1 1 1 1 1 1 
