23 22
1 1 1 1 1 1 1 1 0 0 0 0 0 0 0 0 0 0 0 0 0 0
1 0 0 0 50 40 41 1 0 0 0 0 0 0 0 0 0 0 0 0 0 0
1 22 1 0 0 0 0 1 0 0 0 0 0 0 0 1 1 1 1 1 1 1
1 1 1 0 0 0 0 1 1 1 1 1 1 1 1 1 0 0 0 1 0 1
1 0 1 30 0 30 0 23 0 0 83 0 0 0 0 23 0 0 0 1 0 1
1 1 1 1 1 1 1 1 1 1 1 1 82 0 0 1 1 1 1 1 22 1
1 0 0 0 1 0 0 0 1 0 0 1 0 100 0 0 0 0 0 0 0 1
1 0 0 0 1 0 0 0 1 0 0 1 0 0 0 0 0 0 80 81 0 1
1 1 22 1 1 1 22 1 1 1 22 1 0 0 0 1 1 1 1 1 1 1
1 0 0 0 60 61 62 63 0 0 0 0 0 0 0 1 0 0 0 1 0 0
1 0 0 0 0 0 0 0 0 0 0 0 0 0 0 23 0 0 0 1 0 0
1 1 1 1 22 1 1 1 1 1 22 1 1 1 1 1 1 0 0 1 0 0
0 0 1 0 0 0 1 0 0 1 0 1 0 0 0 0 23 0 0 1 0 0
0 0 1 0 0 1 1 0 0 1 0 1 0 0 1 1 1 0 0 1 0 0
0 0 1 0 0 1 0 0 0 1 0 1 0 0 1 0 0 0 0 1 0 0
0 0 1 1 1 1 1 1 22 1 0 1 1 1 1 0 0 0 0 1 0 0
0 0 0 0 0 1 0 0 0 0 0 0 0 0 0 0 0 1 1 1 1 1
0 0 0 0 0 1 0 0 0 0 0 0 0 0 0 0 0 1 0 0 0 1
0 0 1 1 1 1 22 1 1 1 22 1 1 1 0 0 0 23 0 0 0 1
0 0 1 70 71 0 0 1 0 1 0 0 0 1 0 0 0 1 1 1 1 1
0 0 1 72 73 0 0 1 0 1 1 1 22 1 0 0 0 1 0 0 0 1
0 0 1 0 0 0 0 23 0 0 0 0 0 1 0 0 0 21 0 0 0 1
0 0 1 1 1 1 1 1 1 1 1 1 1 1 1 1 1 1 1 1 1 1
1 1 1 1 1 1 1 1 0 0 0 0 0 0 0 0 0 0 0 0 0 0
1 90 90 90 90 90 90 1 0 0 0 0 0 0 0 0 0 0 0 0 0 0
1 90 1 90 90 90 90 1 0 0 0 0 0 0 0 1 1 1 1 1 1 1
1 1 1 90 90 90 90 1 1 1 1 1 1 1 1 1 90 90 90 1 90 1
1 90 1 90 90 90 90 90 90 90 90 90 90 90 90 90 90 90 90 90 90 90
1 1 1 1 1 1 1 1 1 1 1 1 0 0 0 1 1 1 1 1 22 1
1 0 0 0 1 0 0 0 1 0 0 1 0 0 0 0 0 0 0 0 0 1
1 0 0 0 1 0 0 0 1 0 0 1 0 0 0 0 0 0 0 0 0 1
1 1 22 1 1 1 22 1 1 1 22 1 0 0 0 1 1 1 1 1 1 1
1 0 0 0 60 61 62 63 0 0 0 0 0 0 0 1 0 0 0 1 0 0
1 0 0 0 0 0 0 0 0 0 0 0 0 0 0 23 0 0 0 1 0 0
1 1 1 1 22 1 1 1 1 1 22 1 1 1 1 1 1 0 0 1 0 0
0 0 1 0 0 0 1 0 0 1 0 1 0 0 0 0 23 0 0 1 0 0
0 0 1 0 0 1 1 0 0 1 0 1 0 0 1 1 1 0 0 1 0 0
0 0 1 0 0 1 0 0 0 1 0 1 0 0 1 0 0 0 0 1 0 0
0 0 1 1 1 1 1 1 22 1 0 1 1 1 1 0 0 0 0 1 0 0
0 0 0 0 0 1 0 0 0 0 0 0 0 0 0 0 0 1 1 1 1 1
0 0 0 0 0 1 0 0 0 0 0 0 0 0 0 0 0 1 0 0 0 1
0 0 1 1 1 1 22 1 1 1 22 1 1 1 0 0 0 23 0 0 0 1
0 0 1 70 71 0 0 1 0 1 0 0 0 1 0 0 0 1 1 1 1 1
0 0 1 72 73 0 0 1 0 1 1 1 22 1 0 0 0 1 0 0 0 1
0 0 1 0 0 0 0 23 0 0 0 0 0 1 0 0 0 21 0 0 0 1
0 0 1 1 1 1 1 1 1 1 1 1 1 1 1 1 1 1 1 1 1 1
1 1 1 1 1 1 1 1 0 0 0 0 0 0 0 0 0 0 0 0 0 0
1 0 0 0 50 40 41 1 0 0 0 0 0 0 0 0 0 0 0 0 0 0
1 22 1 0 0 0 0 1 0 0 0 0 0 0 0 1 1 1 1 1 1 1
1 1 1 0 100 0 0 1 1 1 1 1 1 1 1 1 0 0 0 1 0 1
1 0 1 30 0 30 0 23 0 0 0 0 0 0 0 23 0 0 0 1 0 1
1 1 1 1 1 1 1 1 1 1 1 1 0 0 0 1 1 1 1 1 22 1
1 0 0 0 1 0 0 0 1 0 0 1 0 0 0 0 0 0 0 0 0 1
1 0 0 0 1 0 0 0 1 0 0 1 0 0 0 0 0 0 0 0 0 1
1 1 22 1 1 1 22 1 1 1 22 1 0 0 0 1 1 1 1 1 1 1
1 0 0 0 60 61 62 63 0 0 0 0 0 0 0 1 0 0 0 1 0 0
1 0 0 0 0 0 0 0 0 0 0 0 0 0 0 23 0 0 0 1 0 0
1 1 1 1 22 1 1 1 1 1 22 1 1 1 1 1 1 0 0 1 0 0
0 0 1 0 0 0 1 0 0 1 0 1 0 0 0 0 23 0 0 1 0 0
0 0 1 0 0 1 1 0 0 1 0 1 0 0 1 1 1 0 0 1 0 0
0 0 1 0 0 1 0 0 0 1 0 1 0 0 1 0 0 0 0 1 0 0
0 0 1 1 1 1 1 1 22 1 0 1 1 1 1 0 0 0 0 1 0 0
0 0 0 0 0 1 0 0 0 0 0 0 0 0 0 0 0 1 1 1 1 1
0 0 0 0 0 1 0 0 0 0 0 0 0 0 0 0 0 1 0 0 0 1
0 0 1 1 1 1 22 1 1 1 22 1 1 1 0 0 0 23 0 0 0 1
0 0 1 70 71 0 0 1 0 1 0 0 0 1 0 0 0 1 1 1 1 1
0 0 1 72 73 0 0 1 0 1 1 1 22 1 0 0 0 1 0 0 0 1
0 0 1 0 0 0 0 23 0 0 0 0 0 1 0 0 0 21 0 0 0 1
0 0 1 1 1 1 1 1 1 1 1 1 1 1 1 1 1 1 1 1 1 1
30 0 0 3 3
30 0 1 3 5
30 0 2 4 5
30 0 3 4 3
30 1 0 2 3
30 1 1 2 5
30 1 2 3 5