30 21
0 0 0 0 0 0 0 0 0 1 1 1 0 0 0 0 0 0 0 0 0
0 0 0 0 0 0 0 0 0 1 100 1 0 0 0 0 0 0 0 0 0
0 0 0 0 0 0 0 0 0 1 0 1 0 0 0 0 0 0 0 0 0
0 0 0 1 1 1 1 1 0 1 0 1 1 1 1 1 0 0 0 0 0
0 0 0 1 70 70 70 1 0 1 0 1 75 36 75 1 0 0 0 0 0
0 0 0 1 0 0 0 1 0 1 0 21 0 0 0 1 0 0 0 0 0
1 1 1 1 1 22 1 1 1 1 0 1 0 0 0 1 0 0 0 0 0
1 71 71 0 1 0 0 23 0 0 0 1 1 1 22 1 0 0 0 0 0
1 50 0 0 23 0 1 1 1 1 20 1 61 1 0 1 0 0 0 0 0
1 71 71 0 1 0 1 0 0 0 0 0 0 1 0 1 1 1 1 1 0
1 1 1 1 1 0 1 75 51 72 72 72 75 1 0 1 34 0 32 1 0
1 70 70 40 1 0 1 1 1 1 1 1 1 1 0 1 0 0 0 1 0
1 50 0 0 23 0 0 0 0 0 0 0 0 0 0 23 0 0 37 1 0
1 1 1 1 1 1 1 1 1 1 0 1 1 1 1 1 0 0 37 1 0
0 0 0 0 0 1 0 0 30 1 0 1 34 50 36 0 0 0 75 1 0
0 0 0 0 0 1 0 71 0 23 0 1 0 0 0 0 0 0 0 1 0
0 0 0 0 0 1 0 52 0 1 0 1 41 0 0 75 0 0 72 1 0
1 1 1 1 1 1 0 0 0 1 0 1 1 1 20 1 20 1 1 1 0
1 75 36 36 36 1 1 1 1 1 0 0 0 0 0 1 0 1 0 0 0
1 0 0 0 0 0 0 0 0 0 0 1 1 1 1 1 0 1 0 0 0
1 0 0 0 0 1 1 1 1 1 0 23 0 0 0 0 0 1 0 0 0
1 35 0 0 0 23 0 70 70 1 0 1 1 1 1 0 0 1 0 0 0
1 1 22 1 1 1 41 0 0 1 0 0 0 32 1 0 0 1 1 1 1
0 1 0 1 52 1 1 1 22 1 75 0 0 37 1 0 0 1 75 32 1
0 1 0 1 53 0 71 1 0 1 75 0 0 33 1 0 0 23 0 30 1
0 1 0 1 1 20 1 1 0 1 1 22 1 1 1 0 0 1 50 33 1
0 1 0 0 0 0 0 0 0 0 0 0 0 0 0 0 0 1 1 1 1
0 1 39 0 0 0 0 0 0 0 75 0 0 0 75 0 0 23 0 1 0
0 1 75 0 0 0 75 38 0 0 0 0 0 0 0 0 0 1 62 1 0
0 1 1 1 1 1 1 1 1 1 1 1 1 1 1 1 1 1 1 1 0
0 0 0 0 0 0 0 0 0 0 0 0 0 0 0 0 0 0 0 0 0
0 0 0 0 0 0 0 0 0 0 1 0 0 0 0 0 0 0 0 0 0
0 0 0 0 0 0 0 0 0 0 1 0 0 0 0 0 0 0 0 0 0
0 0 0 0 0 0 0 0 0 0 1 0 0 0 0 0 0 0 0 0 0
0 0 0 0 1 1 1 0 0 0 1 0 1 1 1 0 0 0 0 0 0
0 0 0 0 1 1 1 0 0 0 1 0 1 1 1 0 0 0 0 0 0
0 0 0 0 0 0 0 0 0 0 1 0 1 1 1 0 0 0 0 0 0
0 1 1 1 0 1 1 0 1 1 1 0 0 0 0 0 0 0 0 0 0
0 1 1 1 0 1 0 0 0 0 0 0 1 0 1 0 0 0 0 0 0
0 1 1 1 0 1 0 1 1 1 1 1 1 0 1 0 0 0 0 0 9
0 0 0 0 0 1 0 1 1 1 1 1 1 0 1 0 1 1 1 0 0
0 1 1 1 0 1 0 0 0 0 0 0 0 0 1 0 1 1 1 0 0
0 1 1 1 0 1 1 1 1 1 1 1 1 1 1 0 1 1 1 0 0
0 0 0 0 0 0 0 0 0 0 1 0 0 0 0 0 1 1 1 0 0
1 1 1 1 1 0 1 1 1 0 1 0 1 1 1 1 1 1 1 0 0
1 1 1 1 1 0 1 1 1 0 1 0 1 1 1 1 1 1 1 0 0
1 1 1 1 1 0 1 1 1 0 1 0 1 1 1 1 1 1 1 0 0
0 0 0 0 0 0 1 1 1 0 1 0 0 0 0 0 0 0 0 0 0
0 1 1 1 1 0 0 0 0 0 1 1 1 1 1 0 1 0 0 0 0
0 1 1 1 1 1 1 1 1 1 1 0 0 0 0 0 1 0 0 0 0
0 1 1 1 1 0 0 0 0 0 1 0 1 1 1 1 1 0 0 0 0
0 1 1 1 1 0 1 1 1 0 1 0 0 0 0 1 1 0 0 0 0
0 0 0 0 0 0 1 1 1 0 1 1 1 1 0 1 1 0 0 0 0
0 0 1 0 1 0 0 0 0 0 1 1 1 1 0 1 1 0 1 1 0
0 0 1 0 1 1 1 0 1 0 1 1 1 1 0 1 1 0 1 1 0
0 0 1 0 0 0 0 0 1 0 0 0 0 0 0 1 1 0 1 1 0
0 0 1 1 1 1 1 1 1 1 1 1 1 1 1 1 1 0 0 0 0
0 0 1 1 1 1 1 1 1 1 1 1 1 1 1 1 1 0 1 0 0
0 0 1 1 1 1 1 1 1 1 1 1 1 1 1 1 1 0 1 0 0
0 0 0 0 0 0 0 0 0 0 0 0 0 0 0 0 0 0 0 0 0
30 0 0 17 8
30 0 1 17 6
30 0 2 14 6
30 0 3 14 7
30 1 0 20 12
30 1 1 24 8
30 1 2 27 18
30 1 3 24 16