30 21
0 0 0 0 0 0 0 0 0 1 1 1 0 0 0 0 0 0 0 0 0
0 0 0 0 0 0 0 0 0 1 100 1 0 0 0 0 0 0 0 0 0
0 0 0 0 0 0 0 0 0 1 0 1 0 0 0 0 0 0 0 0 0
0 0 0 1 1 1 1 1 0 1 0 1 1 1 1 1 0 0 0 0 0
0 0 0 1 70 70 70 1 0 1 0 1 75 0 75 1 0 0 0 0 0
0 0 0 1 0 0 0 1 0 1 0 1 0 0 0 1 0 0 0 0 0
1 1 1 1 1 1 1 1 1 1 0 1 0 0 0 1 0 0 0 0 0
1 0 0 0 1 0 0 0 0 0 0 1 1 1 1 1 0 0 0 0 0
1 0 0 0 1 0 1 1 1 1 1 1 0 1 0 1 0 0 0 0 0
1 0 0 0 1 0 1 0 0 0 0 0 0 1 0 1 1 1 1 1 0
1 1 1 1 1 0 1 0 0 0 0 0 0 1 0 1 0 0 0 1 0
1 0 0 0 1 0 1 1 1 1 1 1 1 1 0 1 0 0 0 1 0
1 0 0 0 1 0 0 0 0 0 0 0 0 0 0 1 0 0 0 1 0
1 1 1 1 1 1 1 1 1 1 0 1 1 1 1 1 0 0 0 1 0
0 0 0 0 0 1 0 0 0 1 0 1 0 0 0 0 0 0 0 1 0
0 0 0 0 0 1 0 0 0 1 0 1 0 0 0 0 0 0 0 1 0
0 0 0 0 0 1 0 0 0 1 0 1 0 0 0 0 0 0 0 1 0
1 1 1 1 1 1 0 0 0 1 0 1 1 1 1 1 1 1 1 1 0
1 0 0 0 0 1 1 1 1 1 0 0 0 0 0 1 0 1 0 0 0
1 0 0 0 0 0 0 0 0 0 0 1 1 1 1 1 0 1 0 0 0
1 0 0 0 0 1 1 1 1 1 0 1 0 0 0 0 0 1 0 0 0
1 0 0 0 0 1 0 0 0 1 0 1 1 1 1 0 0 1 0 0 0
1 1 1 1 1 1 0 0 0 1 0 0 0 0 1 0 0 1 1 1 1
0 1 0 1 0 1 1 1 1 1 0 0 0 0 1 0 0 1 0 0 1
0 1 0 1 0 0 0 1 0 1 0 0 0 0 1 0 0 1 0 0 1
0 1 0 1 1 1 1 1 0 1 1 1 1 1 1 0 0 1 0 0 1
0 1 0 0 0 0 0 0 0 0 0 0 0 0 0 0 0 1 1 1 1
0 1 0 0 0 0 0 0 0 0 0 0 0 0 0 0 0 1 0 1 0
0 1 0 0 0 0 0 0 0 0 0 0 0 0 0 0 0 1 0 1 0
0 1 1 1 1 1 1 1 1 1 1 1 1 1 1 1 1 1 1 1 0
0 0 0 0 0 0 0 0 0 0 0 0 0 0 0 0 0 0 0 0 0
0 0 0 0 0 0 0 0 0 0 1 0 0 0 0 0 0 0 0 0 0
0 0 0 0 0 0 0 0 0 0 1 0 0 0 0 0 0 0 0 0 0
0 0 0 0 0 0 0 0 0 0 1 0 0 0 0 0 0 0 0 0 0
0 0 0 0 1 1 1 0 0 0 1 0 1 1 1 0 0 0 0 0 0
0 0 0 0 1 1 1 0 0 0 1 0 1 1 1 0 0 0 0 0 0
0 0 0 0 0 0 0 0 0 0 1 0 1 1 1 0 0 0 0 0 0
0 1 1 1 0 1 1 1 1 1 1 0 0 0 0 0 0 0 0 0 0
0 1 1 1 0 1 0 0 0 0 0 0 1 0 1 0 0 0 0 0 0
0 1 1 1 0 1 0 1 1 1 1 1 1 0 1 0 0 0 0 0 0
0 0 0 0 0 1 0 1 1 1 1 1 1 0 1 0 1 1 1 0 0
0 1 1 1 0 1 0 0 0 0 0 0 0 0 1 0 1 1 1 0 0
0 1 1 1 0 1 1 1 1 1 1 1 1 1 1 0 1 1 1 0 0
0 0 0 0 0 0 0 0 0 0 1 0 0 0 0 0 1 1 1 0 0
0 0 0 0 0 0 1 1 1 0 1 0 1 1 1 1 1 1 1 0 0
0 0 0 0 0 0 1 1 1 0 1 0 1 1 1 1 1 1 1 0 0
0 0 0 0 0 0 1 1 1 0 1 0 1 1 1 1 1 1 1 0 0
0 0 0 0 0 0 1 1 1 0 1 0 0 0 0 0 0 0 0 0 0
0 1 1 1 1 0 0 0 0 0 1 1 1 1 1 0 1 0 0 0 0
0 1 1 1 1 1 1 1 1 1 1 0 0 0 0 0 1 0 0 0 0
0 1 1 1 1 0 0 0 0 0 1 0 1 1 1 1 1 0 0 0 0
0 1 1 1 1 0 1 1 1 0 1 0 0 0 0 1 1 0 0 0 0
0 0 0 0 0 0 1 1 1 0 1 1 1 1 0 1 1 0 0 0 0
0 0 1 0 1 0 0 0 0 0 1 1 1 1 0 1 1 0 1 1 0
0 0 1 0 1 1 1 0 1 0 1 1 1 1 0 1 1 0 1 1 0
0 0 1 0 0 0 0 0 1 0 0 0 0 0 0 1 1 0 1 1 0
0 0 1 1 1 1 1 1 1 1 1 1 1 1 1 1 1 0 0 0 0
0 0 1 1 1 1 1 1 1 1 1 1 1 1 1 1 1 0 1 0 0
0 0 1 1 1 1 1 1 1 1 1 1 1 1 1 1 1 0 1 0 0
0 0 0 0 0 0 0 0 0 0 0 0 0 0 0 0 0 0 0 0 0