5 5
1 1 1 1 1
1 0 100 50 1
1 1 20 1 1
1 50 50 50 1
1 1 1 1 1